FINAL LEVEL
8 11
+++++++++  
+ *     +   
+ ++#++ +++  
+*    W +*+  
++ +++# + +  
+     #   +  
+   +     +  
+++++++++++  